w,w,w,s,s,w
w,w,w,s,s,w
w,w,w,s,s,w
w,w,w,s,s,w
w,w,w,s,s,w
w,w,w,s,s,w
w,w,w,s,s,w
w,w,w,s,s,w
w,w,w,s,s,w
w,w,w,s,s,w
w,w,w,s,s,w
w,w,w,s,s,w
w,w,w,s,s,w
w,w,w,s,s,w
w,w,w,s,s,w
w,w,d,p,p,d
w,d,g,p,p,g
d,d,d,p,p,d
w,w,w,s,s,w
w,w,w,s,s,w
w,w,w,s,s,w
w,w,w,s,s,w
w,w,w,s,s,w
w,w,w,s,s,w
w,w,w,s,s,w
w,w,w,s,s,w
w,w,w,s,s,w
w,w,d,p,p,g
w,d,g,p,p,g
d,g,g,p,p,g
g,g,g,p,p,g
g,p,p,p,p,g
g,p,p,p,p,g
g,p,p,g,g,g
g,p,p,g,g,g
g,p,p,g,g,g